111111111111111
10010C00000C111
100000000000111
10C0011C00001C1
1P0011E000C0111
111111111111111
