11111111111111111111111111111111111111111111111111
10010000000C00000000000000000000000000000000000001
1E000111110010000000000000000000000000000000000001
1P001100000010000000000000000000000000000000000001
11111111111111111111111111111111111111111111111111
