1111111111
1P000000E1
1110111011
1C000000C1
1011101111
1C000000C1
1010111011
1C000000C1
1111111111
