1111111111111
10010C00000C1
1000000000001
10C0011C00001
1P0011E000C01
