1111111111111
1001000000001
1000000000001
1000011000001
1000110000001
1111111111111
