111111111111111
100000000000001
100000111000001
1000001P1000001
1000001C1000001
1000001E1000001
100000111000001
100000000000001
111111111111111
